10 10
. . . . . . . . . .
. . . . . . . . . .
. . . . . . . . . .
. . . . # . . . . .
. . S . # . . T . .
. . . . # . . . . .
. . . . # # . . . .
. . . . . . . . . .
. . . . . . . . . .
. . . . . . . . . .
