1 10 10
.   .   .   .   .   .   .   .   .   .
.   .   .   .   .   .   .   .   .   .
.   .   .   .   .   .   .   .   .   .
.   .   .   .   #   .   .   .   .   .
.   .   S1  .   #   .   .   T1  .   .
.   .   .   .   #   .   .   .   .   .
.   .   S2  .   #   #   .   T2  .   .
.   .   .   .   .   .   .   .   .   .
.   .   .   .   .   .   .   .   .   .
.   .   .   .   .   .   .   .   .   .